0101011100000001
0101100000000010
0101100100000100
0101101000001000
0101110000000011
0101110100001000
0000000100001011
0101000000010010
0101000011111111
0000000101101011
0101011000010011
0101011011111111
1000010100110110
0000000101101011
0101011000010001
0101011011111111
1000010101000110
0000000101101011
0101011000000010
0101011011111111
1000010100010110
0000000101101011
0101011000100010
0101011011111111
1000010100100110
0000101110110101
0100000000011010
0000101101010111
0100000000100100
0000101101011000
0100000000111101
0000101101011001
0100000001101111
0000101101011010
0100000001010110
0000101110000011
0100000000011010
0000101111000011
0100000010001000
1000011100001011
0101000000000001
0000000101101011
0000010101100000
0101011000000001
1000010100110110
0000000101101011
0000010101100000
1001011000000001
1000010101000110
0000000101101011
0000010101100000
1001011000010000
1000010100010110
0000000101101011
0000010101100000
0101011000010000
1000010100100110
1000011100000111
0000000101011011
0100111000011010
0000101110000100
0100000000011010
0000101111000100
0100000010001000
1000011100001011
1001000000000001
0000000101101011
0000010101100000
0101011000000001
1000010100110110
0000000101101011
0000010101100000
1001011000000001
1000010101000110
0000000101101011
0000010101100000
1001011000010000
1000010100010110
0000000101101011
0000010101100000
0101011000010000
1000010100100110
1000011100000111
0000000101011011
0100111000011010
0000101110000001
0100000000011010
0000101111000001
0100000010001000
1000011100001011
1001000000010000
0000000101101011
0000010101100000
0101011000000001
1000010100110110
0000000101101011
0000010101100000
1001011000000001
1000010101000110
0000000101101011
0000010101100000
1001011000010000
1000010100010110
0000000101101011
0000010101100000
0101011000010000
1000010100100110
1000011100000111
0000000101011011
0100111000011010
0000101110000010
0100000000011010
0000101111000010
0100000010001000
1000011100001011
0101000000010000
0000000101101011
0000010101100000
0101011000000001
1000010100110110
0000000101101011
0000010101100000
1001011000000001
1000010101000110
0000000101101011
0000010101100000
1001011000010000
1000010100010110
0000000101101011
0000010101100000
0101011000010000
1000010100100110
1000011100000111
0000000101011011
0100111000011010
1000011100001101